20,10
********************
*--------*|*|*|*|*|*
********|*|*|*|*|*|*
|*|*|*|*|*|*|*****|*
|*|*|*|*|*|*|*----|*
|*|*|*|*|*|*|*****|*
|*|G|*|*|G|*|G---*|*
|*|*|*|*|*|*|*|*|*|*
**********|*|*|*****
--------------------

