10,10
**********
*--------*
********|*
*|**G***|*
*|********
*|******|*
*|********
********|*
*--------*
**********
