10,10
**********
*****---|*
*+-+****|*
*|*|G***|*
*|*|******
*|*|****|*
*|*|******
**_*****|*
******--|*
-----*****
