10,10
**********
*--------*
***|*-**|*
*|*|G*|*|*
*|****|***
*|*|G*|*|*
*|********
********|*
*--------*
**********
